11111111111111111111
10101010101010100011
10101010101010101011
10000000000000001011
10011001100110011001
10011001100110011011
10011001100110011001
10000000000000001000
10000011000011001001
10000011000011001011
10011001100110011001
10010000100010001011
10000000000000001011
11111010101010101011
10000000000000001011
11111111111111111111