1111101
0000000
1111011
1000011
1010111
1000111
1111111